いしもりにじか	石森虹花	人名	欅坂
いまいずみゆい	今泉佑唯	人名	欅坂
うえむらりな	上村莉菜	人名	欅坂
おぜきりか	尾関梨香	人名	欅坂
おだなな	織田奈那	人名	欅坂
こいけみなみ	小池美波	人名	欅坂
こばやしゆい	小林由依	人名	欅坂
さいとうふゆか	齋藤冬優花	人名	欅坂
さとうしおり	佐藤詩織	人名	欅坂
しだまなか	志田愛佳	人名	欅坂
すがいゆうか	菅井友香	人名	欅坂
すずもとみゆ	鈴本美愉	人名	欅坂
ながさわななこ	長沢菜々香	人名	欅坂
はぶみづほ	土生瑞穗	人名	欅坂
はらだあおい	原田葵	人名	欅坂
ひらてゆりな	平手友梨奈	人名	欅坂
もりやあかね	守屋茜	人名	欅坂
よねたにななみ	米谷奈々未	人名	欅坂
わたなべりか	渡辺梨加	人名	欅坂
わたなべりさ	渡邉理佐	人名	欅坂
いぐちまお	井口眞緒	人名	けやき坂
うしおさりな	潮紗理菜	人名	けやき坂
かきざきめみ	柿崎芽実	人名	けやき坂
かげやまゆうか	影山優佳	人名	けやき坂
かとうしほ	加藤史帆	人名	けやき坂
さいとうきょうこ	齊藤京子	人名	けやき坂
ささきくみ	佐々木久美	人名	けやき坂
ささきみれい	佐々木美玲	人名	けやき坂
たかせまな	高瀬愛奈	人名	けやき坂
たかもとあやか	高本彩花	人名	けやき坂
ながはまねる	長濱ねる	人名	けやき坂・欅坂
ひがしむらめい	東村芽依	人名	けやき坂
あきもとまなつ	秋元真夏	人名	乃木坂1期生
いくたえりか	生田絵梨花	人名	乃木坂1期生
いこまりな	生駒里奈	人名	乃木坂1期生
いとうかりん	伊藤かりん	人名	乃木坂2期生
いとうじゅんな	伊藤純奈	人名	乃木坂2期生
いとうまりか	伊藤万理華	人名	乃木坂1期生
いとうりりあ	伊藤理々杏	人名	乃木坂3期生
いのうえさゆり	井上小百合	人名	乃木坂1期生
いわもとれんか	岩本蓮加	人名	乃木坂3期生
うめざわみなみ	梅澤美波	人名	乃木坂3期生
えとうみさ	衛藤美彩	人名	乃木坂1期生
おおぞのももこ	大園桃子	人名	乃木坂3期生
かわごひな	川後陽菜	人名	乃木坂1期生
かわむらまひろ	川村真洋	人名	乃木坂1期生
きたのひなこ	北野日奈子	人名	乃木坂2期生
くぼしおり	久保史緒里	人名	乃木坂3期生
さいとうあすか	齋藤飛鳥	人名	乃木坂1期生
さいとうちはる	斎藤ちはる	人名	乃木坂1期生
さいとうゆうり	斉藤優里	人名	乃木坂1期生
さかぐちたまみ	阪口珠美	人名	乃木坂3期生
さがらいおり	相楽伊織	人名	乃木坂2期生
さくらいれいか	桜井玲香	人名	乃木坂1期生
ささきことこ	佐々木琴子	人名	乃木坂2期生
さとうかえで	佐藤楓	人名	乃木坂3期生
しらいしまい	白石麻衣	人名	乃木坂1期生
しんうちまい	新内眞衣	人名	乃木坂2期生
すずきあやね	鈴木絢音	人名	乃木坂2期生
たかやまかずみ	高山一実	人名	乃木坂1期生
てらだらんぜ	寺田蘭世	人名	乃木坂2期生
なかだかな	中田花奈	人名	乃木坂1期生
なかむられの	中村麗乃	人名	乃木坂3期生
なかもとひめか	中元日芽香	人名	乃木坂1期生
にしのななせ	西野七瀬	人名	乃木坂1期生
のうじょうあみ	能條愛未	人名	乃木坂1期生
はしもとななみ	橋本奈々未	人名	乃木坂1期生
ひぐちひな	樋口日奈	人名	乃木坂1期生
ほしのみなみ	星野みなみ	人名	乃木坂1期生
ほりみおな	堀未央奈	人名	乃木坂2期生
まつむらさゆり	松村沙友理	人名	乃木坂1期生
むかいはづき	向井葉月	人名	乃木坂3期生
やまざきれな	山﨑怜奈	人名	乃木坂2期生
やましたみづき	山下美月	人名	乃木坂3期生
よしだあやのくりすてぃー	吉田綾乃クリスティー	人名	乃木坂3期生
よだゆうき	与田祐希	人名	乃木坂3期生
わかつきゆみ	若月佑美	人名	乃木坂1期生
わだまあや	和田まあや	人名	乃木坂1期生
わたなべみりあ	渡辺みり愛	人名	乃木坂2期生
